Sac à main	Textile > Vêtement et accessoire > Accessoire
Fauteuil visiteur	Siège > Fauteuil > Fauteuil visiteur
Fauteuil de bureau	Siège > Fauteuil > Fauteuil de bureau
Fauteuil de bureau\n	Siège > Fauteuil > Fauteuil de bureau
Fauteuil confortable	Siège > Fauteuil > Fauteuil confortable
Confortable	Siège > Fauteuil > Fauteuil confortable
Fauteuil confortable	Siège > Fauteuil > Fauteuil confortable
Fauteuil Cabriolet	Siège > Fauteuil > Fauteuil cabriolet
Chaise Lyre	Siège > Chaise > Chaise lyre
Chaise lyre	Siège > Chaise > Chaise lyre
Chaise lyre\nChaise a été vendues au domaine en 1987.	Siège > Chaise > Chaise lyre
Chaise à lyre	Siège > Chaise > Chaise lyre
CHAISE A GRILLE N° 1	Siège > Chaise > Chaise à grille
CHAISE A GRILLE N° 1\n	Siège > Chaise > Chaise à grille
CHAISE A GRILLE N° 2\nNOIRE	Siège > Chaise > Chaise à grille
CHAISE A GRILLE N° 3	Siège > Chaise > Chaise à grille
CHAISE A JOUREE	Siège > Chaise > Chaise à grille
CHAISE AJOUREE	Siège > Chaise > Chaise à grille
CHAISE MEDAILLON	Siège > Chaise
Chaise Gondole	Siège > Chaise
Chaise légère	Siège > Chaise
Canapé	Siège > Canapé
Canapé\nDécision de radiation n°2012/05 du 09.07.2012 pour être reversé au Conseil général de Loir-e	Siège > Canapé
Canapé "Hudson"	Siège > Canapé
Canapé 2 places	Siège > Canapé
Canapé 2 places\nDécision de radiation n°2013/03 du 27.08.2013 pour destruction	Siège > Canapé
Canapé 2 places\nDécision de radiation n°2018/02 du 18/04/2018 suite à la vente aux Domaines du 27 m	Siège > Canapé
Canapé 2 places\nModèle Aura	Siège > Canapé
Canapé 2 places\nModèle Coque	Siège > Canapé
Canapé 2 places\nModèle Drisin	Siège > Canapé
Canapé 2 places\nModèle LC2	Siège > Canapé
Canapé 2 places\nModèle LC2 de 1928	Siège > Canapé
Canapé 2 places\nModèle Marly	Siège > Canapé
Canapé 2 places\nModèle Quai Conti	Siège > Canapé
Canapé 2 places\nModèle Savane	Siège > Canapé
Canapé 2 places\nP.V. VENTE 07 99/2105\nREMIS EN VENTE LE 21.12.1999\nARRETE DU 23.12.1999	Siège > Canapé
Canapé 2 places\nP.V. VENTE 17 2002-FEV-0065\nARRETE DU 07.06.2002	Siège > Canapé
Canapé 2 places\nP.V. VENTE 38 96/1630\nARRETE DU 20.11.1996\n	Siège > Canapé
Canapé 2 places\nP.V. VENTE 57 98/1992\nINVENDU - DETRUIT - P.V. 03\nARRETE DU 22.02.1999\n\n\n	Siège > Canapé
Canapé 2 places\nSister Mangaret	Siège > Canapé
Canapé 2 places\nmodèle California	Siège > Canapé
Canapé 2 places Foster	Siège > Canapé
Canapé 2 places modèle Drisin	Siège > Canapé
Canapé 2 places-méridienne Essex	Siège > Canapé
Canapé 2 places. Modèle LC2 de 1928	Siège > Canapé
Canapé 3 places	Siège > Canapé
Canapé 3 places\nModèle Bastiano	Siège > Canapé
Canapé 3 places\nModèle Drisin	Siège > Canapé
Canapé 3 places\nModèle LC2	Siège > Canapé
Canapé 3 places\nModèle Washington	Siège > Canapé
Canapé 3 places\nP.V. VENTE 17 2002-FEV-0065\nARRETE DU 07.06.2002	Siège > Canapé
Canapé 3 places\nP.V. VENTE 38 96/1630\nARRETE DU 20.11.1996\n	Siège > Canapé
Canapé 3 places\nSister Mangaret	Siège > Canapé
Canapé 3 places\nmodèle California	Siège > Canapé
Canapé 3 places \nModèle Drisin	Siège > Canapé
Canapé 3 places "Hudson"	Siège > Canapé
Canapé 3 places Foster	Siège > Canapé
Canapé 3 places Kenia	Siège > Canapé
Canapé 3 places modèle Drisin	Siège > Canapé
Canapé 5 places\nP.V. 38 VENTE 96/1630	Siège > Canapé
Canapé Salon Jaujard	Siège > Canapé
Canapé Sofa	Siège > Canapé
Canapé Sopha	Siège > Canapé
Canapé anglais	Siège > Canapé
Canapé cintre	Siège > Canapé
Canapé confortable	Siège > Canapé
Canapé confortable\nDECISION DE RADIATION \nN° 2004/4\nDESTRUCTION	Siège > Canapé
Canapé confortable\nDécision de radiation n° 2005/4\nsuite à la vente du 26 mai 2005	Siège > Canapé
Canapé confortable\nDécision de radiation n°2009/4 du 17/07/2009 suite à la vente du 3/07/2009	Siège > Canapé
Canapé confortable\nP.V. VENTE 3* 92/1569\nARRETE DU 11.09.1992	Siège > Canapé
Canapé confortable\nP.V. VENTE 47 97/2075\nREMIS EN VENTE - VENDU LE 24.02.98 ARRETE DU 04.03.1998\n	Siège > Canapé
Canapé confortable\nP.V. VENTE 47 97/2075 REFUSE\nREBUT 51 ARRETE DU 16.04.98	Siège > Canapé
Canapé confortable\nRADIATION DES INVENTAIRES\nARRETE DU 22.08.1990 \nP.V. DE REBUT	Siège > Canapé
Canapé confortable\nRADIATION DES INVENTAIRES ARRETE DU \n S.H.A.P.E. MARNES LA COQUETTE	Siège > Canapé
Canapé confortable\nRADIATION DES INVENTAIRES ARRETE DU 30.03.1990 S.H.A.P.E. MARNES LA COQUETTE	Siège > Canapé
Canapé confortable "Les illusions d'Icare"	Siège > Canapé
Canapé confortable 2 places	Siège > Canapé
Canapé confortable 3 places	Siège > Canapé
Canapé confortable à 2 places	Siège > Canapé
Canapé contemporain	Siège > Canapé
Canapé corbeille	Siège > Canapé
Canapé corbeille.\nDécision de transfert d' affectation\nn° 2005/14	Siège > Canapé
Canapé d'alcove	Siège > Canapé
Canapé d'angle	Siège > Canapé
Canapé deux places	Siège > Canapé
Canapé deux places\nGamme cosmos executive	Siège > Canapé
Canapé deux places\nModèle Huit	Siège > Canapé
Canapé deux places\nModèle huit	Siège > Canapé
Canapé en bergère	Siège > Canapé
Canapé et garniture du canapé	Siège > Canapé
Canapé gondole	Siège > Canapé
Canapé mural	Siège > Canapé
Canapé sofa	Siège > Canapé
Canapé trois places	Siège > Canapé
Canapé à 3 places\nDestruction le 17 mai 2005\nDécision de radiation 2006/1	Siège > Canapé
Canapé à joues	Siège > Canapé
Canapé-lit	Siège > Canapé
Canapé-lit\nDécision de radiation n° 2005/3 pour destruction du 2 juin 2005.	Siège > Canapé
Canapé-lit\nP.V. VENTE 38 96/1630\nARRETE DU 06.01.1997\n	Siège > Canapé
Canapé-lit "Las Végas"	Siège > Canapé
VASE DE FLEURS	Objet décoratif > Vase
VASE DE FLEURS DRAPERIES	Objet décoratif > Vase
VASE ET FLEURS	Objet décoratif > Vase
VASE ETRUSQUE\nradié des inventaires du mobilier national par arrêté ministériel du 15.04.1994	Objet décoratif > Vase
VASES DE FLEURS	Objet décoratif > Vase
VASES FLEURS BOUQUET	Objet décoratif > Vase
Vase	Objet décoratif > Vase
Vase\n	Objet décoratif > Vase
Vase\nDécision de radiation N° 2004/10\nRestitution au Ministère des Affaires Etrangères	Objet décoratif > Vase
Vase\nDécision de radiation n°2012/01 du 09.02.2012 pour être reversé aux collections du FNAC	Objet décoratif > Vase
Vase\nFleurs au naturel	Objet décoratif > Vase
Vase\nHomère et Bélisaire	Objet décoratif > Vase
Vase\nHérons et prunier rose	Objet décoratif > Vase
Vase\nRADIATION DES INVENTAIRES\nARRETE DU 17.11.1981\nAMBASSADE A VARSOVIE	Objet décoratif > Vase
Vase\nRADIATION DES INVENTAIRES \nARRETE DU 08.04.1980\nMINISTERE DE L INTERIEUR	Objet décoratif > Vase
Vase\nRADIATION DES INVENTAIRES \nARRETE DU 08.04.1980\nPALAIS DE JUSTICE	Objet décoratif > Vase
Vase\nRADIATION DES INVENTAIRES \nARRETE DU 24.12.1979 MINISTERE D AFFAIRES SOCIALES	Objet décoratif > Vase
Vase\nRADIATION DES INVENTAIRES \nARRETE DU 8.04.1980 MINISTERE D AFFAIRES SOCIALES	Objet décoratif > Vase
Vase\nRADIATION DES INVENTAIRES \nARRETE DU 09.04.1993\nAMBASSADE A LONDRES	Objet décoratif > Vase
Vase\nRADIATION DES INVENTAIRES \nARRETE DU 12.01.1985\nAMBASSADE A PRAGUE \n	Objet décoratif > Vase
Vase\nRADIATION DES INVENTAIRES ARRETE DU 10.08.1983\nAMBASSADE A DUBLIN	Objet décoratif > Vase
Vase\nRADIATION DES INVENTAIRES ARRETE DU 15.10.1982\nAMBASSADE A VARSOVIE	Objet décoratif > Vase
Vase\nRADIATION DES INVENTAIRES ARRETE DU 30.10.1984\nAMBASSADE A ATHENES	Objet décoratif > Vase
Vase\nRADIATION DES INVENTAIRES ARRETE DU 30.10.1984\nAMBASSADE A ATHENES	Objet décoratif > Vase
Vase\nRADIATION DES INVENTAIRES ARRETE DU 30.10.1984 LEGATION DE FRANCE A PRAGUE	Objet décoratif > Vase
Vase\nRADIATION DES INVENTAIRES ARRETE DU 29.09.1986\nMOBILIER NATIONAL	Objet décoratif > Vase
Vase	Objet décoratif > Vase
Vase \nRADIATION DES INVENTAIRES \nARRETE DU 29.09.1986\nAMBASSADE A LA HAVANE	Objet décoratif > Vase
Vase "Gauvenet"	Objet décoratif > Vase
Vase "La petite jardinière".	Objet décoratif > Vase
Vase "Le Lavoir"	Objet décoratif > Vase
Vase "Le tambour de basque".	Objet décoratif > Vase
Vase Aiguière	Objet décoratif > Vase
Vase Amphitrite	Objet décoratif > Vase
Vase Aubert	Objet décoratif > Vase
Vase Aubert N°21	Objet décoratif > Vase
Vase Aubert n° 22	Objet décoratif > Vase
Vase Aubert n° 35	Objet décoratif > Vase
Vase Aubert n° 45	Objet décoratif > Vase
Vase Aubert n° 57	Objet décoratif > Vase
Vase Aubert n° 60	Objet décoratif > Vase
Vase Aubert n° 8	Objet décoratif > Vase
Vase Aubert n°40	Objet décoratif > Vase
Vase Bertin	Objet décoratif > Vase
Vase Boileau	Objet décoratif > Vase
Vase Bourdaloue	Objet décoratif > Vase
Vase Bullant\nCapucines/FD Celadon	Objet décoratif > Vase
Vase Clermont	Objet décoratif > Vase
Vase Clodion	Objet décoratif > Vase
Vase Clodion\nLes putti musiciens	Objet décoratif > Vase
Vase Coquery n° 1	Objet décoratif > Vase
Vase Daurat n° 3	Objet décoratif > Vase
Vase De Neptune	Objet décoratif > Vase
Vase Delachenal	Objet décoratif > Vase
Vase Delachenal n° 30	Objet décoratif > Vase
Vase Delachenal n° 86	Objet décoratif > Vase
Vase Delafosse	Objet décoratif > Vase
Vase Domination	Objet décoratif > Vase
Vase Enfants aux pavots	Objet décoratif > Vase
Vase Etrusque	Objet décoratif > Vase
Vase Fleurs fond rouge	Objet décoratif > Vase
Vase Fontaine n° 1	Objet décoratif > Vase
Vase Fontaine n° 2	Objet décoratif > Vase
Vase Gauvenet n°7	Objet décoratif > Vase
Vase IMARI	Objet décoratif > Vase
Vase Jasmin	Objet décoratif > Vase
Vase Jo	Objet décoratif > Vase
Vase L'echo - La source	Objet décoratif > Vase
Vase LES BAIGNEUSES	Objet décoratif > Vase
Vase Lahalle	Objet décoratif > Vase
Vase Lancel	Objet décoratif > Vase
Vase Larue	Objet décoratif > Vase
Vase Maulette	Objet décoratif > Vase
Vase Médicis	Objet décoratif > Vase
Vase Médicis\nDécision de radiation n° 2011/7 du 18-08-2011 pour destruction, les morceaux envoyés à	Objet décoratif > Vase
Vase Médicis monté en lampe	Objet décoratif > Vase
Vase Médicis. Vasque jardinière	Objet décoratif > Vase
Vase Ovoïde	Objet décoratif > Vase
Vase Prou n° 2	Objet décoratif > Vase
Vase Prou n°1	Objet décoratif > Vase
Vase Président	Objet décoratif > Vase
Vase RUHLMANN	Objet décoratif > Vase
Vase Rapin N°14	Objet décoratif > Vase
Vase Rapin n° 21	Objet décoratif > Vase
Vase Rimini	Objet décoratif > Vase
Vase Ruhlmann n° 1	Objet décoratif > Vase
Vase Ruhlmann n°2	Objet décoratif > Vase
Vase Saïgon	Objet décoratif > Vase
Vase Soliflore	Objet décoratif > Vase
Vase Vénus au lion	Objet décoratif > Vase
Vase anses oiseaux et fruits	Objet décoratif > Vase
Vase aux Chimères	Objet décoratif > Vase
Vase avec fleurs	Objet décoratif > Vase
Vase boule	Objet décoratif > Vase
Vase bouteille	Objet décoratif > Vase
Vase bouteille\nFleurs de pêcher	Objet décoratif > Vase
Vase bouteille Toro	Objet décoratif > Vase
Vase bouteille monté en bronze	Objet décoratif > Vase
Vase bouteille montée en bronze	Objet décoratif > Vase
Vase bouteille à décor Imari	Objet décoratif > Vase
Vase cache-pot	Objet décoratif > Vase
Vase cache-pot\nRADIATION DES INVENTAIRES \nARRETE DU 12.01.1985\nAMBASSADE A COPENHAGUE	Objet décoratif > Vase
Vase candélabre	Objet décoratif > Vase
Vase celadon	Objet décoratif > Vase
Vase corbeille	Objet décoratif > Vase
Vase cornet	Objet décoratif > Vase
Vase cornet\nRADIATION DES INVENTAIRES \nARRETE DU 27.01.1981\nAMBASSADE A LA HAVANE	Objet décoratif > Vase
Vase cornet. RADIATION DES INVENTAIRES \nARRETE DU 27.01.1981\nAMBASSADE A LA HAVANE	Objet décoratif > Vase
Vase corps de lampe\nLUSTRERIE EN MORCEAUX	Objet décoratif > Vase
Vase coupe Aubert n°17	Objet décoratif > Vase
Vase couvert	Objet décoratif > Vase
Vase couvert	Objet décoratif > Vase
Vase couvert "Les 4 serpents"	Objet décoratif > Vase
Vase couvert Delafosse	Objet décoratif > Vase
Vase couvert Houdon	Objet décoratif > Vase
Vase couvert couleur cuivre	Objet décoratif > Vase
Vase cylindrique	Objet décoratif > Vase
Vase d'Orfèvrerie	Objet décoratif > Vase
Vase d'Ormesson	Objet décoratif > Vase
Vase d'autel	Objet décoratif > Vase
Vase d'ornement	Objet décoratif > Vase
Vase de Bizerte	Objet décoratif > Vase
Vase de Chine	Objet décoratif > Vase
Vase de Chine monté en lampe	Objet décoratif > Vase
Vase de Delft	Objet décoratif > Vase
Vase de Delft\nRAYE DES INVENTAIRES\nARRETE DU 29.07.1986	Objet décoratif > Vase
Vase de Neptune	Objet décoratif > Vase
Vase de Schilt	Objet décoratif > Vase
Vase de Sèvres	Objet décoratif > Vase
Vase de Sèvres monté en lampe	Objet décoratif > Vase
Vase de Venise	Objet décoratif > Vase
Vase de bronze	Objet décoratif > Vase
Vase de fleurs	Objet décoratif > Vase
Vase de fleurs et perroquet rouge	Objet décoratif > Vase
Vase de fleurs et épagneul	Objet décoratif > Vase
Vase de fruits	Objet décoratif > Vase
Vase de l' Alhambra	Objet décoratif > Vase
Vase de la Renaissance	Objet décoratif > Vase
Vase de nuit	Objet décoratif > Vase
Vase decoeur	Objet décoratif > Vase
Vase dit "Bertin"	Objet décoratif > Vase
Vase dit Bourdaloue	Objet décoratif > Vase
Vase dit Cordelier	Objet décoratif > Vase
Vase dit Egyptien	Objet décoratif > Vase
Vase dit Stéphanie	Objet décoratif > Vase
Vase dit arabe	Objet décoratif > Vase
Vase dit de Neptune	Objet décoratif > Vase
Vase dit de Versailles	Objet décoratif > Vase
Vase dit à oreilles	Objet décoratif > Vase
Vase décor de poissons	Objet décoratif > Vase
Vase en faience	Objet décoratif > Vase
Vase en forme conique	Objet décoratif > Vase
Vase en grès avec fond peint en noir	Objet décoratif > Vase
Vase enfant au cornet	Objet décoratif > Vase
Vase girandole à 3 lumières	Objet décoratif > Vase
Vase jardinière	Objet décoratif > Vase
Vase lampe	Objet décoratif > Vase
Vase lampe Rulmann n° 2	Objet décoratif > Vase
Vase les Arts	Objet décoratif > Vase
Vase les Sciences	Objet décoratif > Vase
Vase monté en bronze	Objet décoratif > Vase
Vase monté en candélabre	Objet décoratif > Vase
Vase oeuf	Objet décoratif > Vase
Vase orné de figures féminines et d'iris\nDécision de radiation n° 2006/15\nreversé au Musée du Louv	Objet décoratif > Vase
Vase pansu	Objet décoratif > Vase
Vase porte-lampes	Objet décoratif > Vase
Vase potiche	Objet décoratif > Vase
Vase soliflore	Objet décoratif > Vase
Vase une parque filant	Objet décoratif > Vase
Vase à amours	Objet décoratif > Vase
Vase à anses	Objet décoratif > Vase
Vase à bouquet de lumières	Objet décoratif > Vase
Vase à couvercle	Objet décoratif > Vase
Vase à couvercle	Objet décoratif > Vase
Vase à couvercle à oiseaux, fleurs	Objet décoratif > Vase
Vase à douze têtes en relief	Objet décoratif > Vase
Vase à têtes de satyres	Objet décoratif > Vase
Vase éclairant monté en bronze	Objet décoratif > Vase
Vase équipé en lampe	Objet décoratif > Vase
Vase étrusque	Objet décoratif > Vase
Pendule borne	Objet décoratif > Horlogerie > Pendule
Pendule borne\n\nCommission de Contrôle du 27 janvier 2016.\nA conserver.	Objet décoratif > Horlogerie > Pendule
Pendule borne\n\nCommission de Contrôle du 27 janvier 2016.\nGamper ?	Objet décoratif > Horlogerie > Pendule
Pendule borne\n\nCommission de Contrôle du 27 janvier 2016.\nVente du 19-01-2017. Radiation n° 2017/	Objet décoratif > Horlogerie > Pendule
Pendule borne\nAir du troubadour	Objet décoratif > Horlogerie > Pendule
Pendule borne\nCADRAN PERRELET	Objet décoratif > Horlogerie > Pendule
Pendule borne\nL'oubli du temps	Objet décoratif > Horlogerie > Pendule
Pendule borne "L'Amour et Psyché"	Objet décoratif > Horlogerie > Pendule
Pendule borne "Les 4 saisons".	Objet décoratif > Horlogerie > Pendule
Pendule borne (avec coupe)	Objet décoratif > Horlogerie > Pendule
Pendule borne antique ornée d'une figure d'étude	Objet décoratif > Horlogerie > Pendule
Pendule borne avec Cadran Robin	Objet décoratif > Horlogerie > Pendule
Pendule borne avec cadran "Franjus à Paris"	Objet décoratif > Horlogerie > Pendule
Pendule borne avec cadran Raingo	Objet décoratif > Horlogerie > Pendule
Pendule borne avec coupe	Objet décoratif > Horlogerie > Pendule
Pendule borne à base rectangulaire	Objet décoratif > Horlogerie > Pendule
Pendule borne-Commission de Contrôle du 27 janvier 2016.\nDécision de radiation n°2017/08 du 11/11/2	Objet décoratif > Horlogerie > Pendule
Pendule cage	Objet décoratif > Horlogerie > Pendule
Pendule cariatide égyptienne	Objet décoratif > Horlogerie > Pendule
Pendule colonne	Objet décoratif > Horlogerie > Pendule
Pendule d'officier	Objet décoratif > Horlogerie > Pendule
Pendule de garniture de cheminée	Objet décoratif > Horlogerie > Pendule
Pendule de nuit en forme de vase	Objet décoratif > Horlogerie > Pendule
Pendule de nuit et de voyage	Objet décoratif > Horlogerie > Pendule
Pendule de voyage dite anglaise	Objet décoratif > Horlogerie > Pendule
Pendule dit de voyage ou d'officier	Objet décoratif > Horlogerie > Pendule
Pendule dite Religieuse	Objet décoratif > Horlogerie > Pendule
Pendule dite de carrosse	Objet décoratif > Horlogerie > Pendule
Pendule dite des Trois horloges	Objet décoratif > Horlogerie > Pendule
Pendule en forme de vase	Objet décoratif > Horlogerie > Pendule
Pendule forme portique	Objet décoratif > Horlogerie > Pendule
Pendule géographique	Objet décoratif > Horlogerie > Pendule
Pendule monument à la mémoire de Frédéric II, roi de Prusse	Objet décoratif > Horlogerie > Pendule
Pendule murale	Objet décoratif > Horlogerie > Pendule
Pendule oeil de boeuf	Objet décoratif > Horlogerie > Pendule
Pendule ornée d'un buste de bacchante	Objet décoratif > Horlogerie > Pendule
Pendule ornée du buste d'Elisa Bonaparte-Baciocchi	Objet décoratif > Horlogerie > Pendule
Pendule piédestal	Objet décoratif > Horlogerie > Pendule
Pendule portique	Objet décoratif > Horlogerie > Pendule
Pendule portique cadran Rieussec	Objet décoratif > Horlogerie > Pendule
Pendule regulateur à cadran émaillé	Objet décoratif > Horlogerie > Pendule
Pendule représentant Galilée	Objet décoratif > Horlogerie > Pendule
Pendule régulateur	Objet décoratif > Horlogerie > Pendule
Pendule régulateur. LES PARTIES DU MONDE	Objet décoratif > Horlogerie > Pendule
Pendule sympathique	Objet décoratif > Horlogerie > Pendule
Pendule troubadour	Objet décoratif > Horlogerie > Pendule
Pendule vase cratère dit "vase aux masques"	Objet décoratif > Horlogerie > Pendule
Pendule à colonnettes	Objet décoratif > Horlogerie > Pendule
Pendule à la gloire de Napoléon III	Objet décoratif > Horlogerie > Pendule
Pendule à musique	Objet décoratif > Horlogerie > Pendule
Pendule-cage	Objet décoratif > Horlogerie > Pendule
Cartel	Objet décoratif > Horlogerie
Assiette	Objet décoratif > Art de la table > Service de table
Assiette\nA Bièvre (Seine et Oise)	Objet décoratif > Art de la table > Service de table
Assiette\nA Darnetal près Rouen (Seine inférieur)	Objet décoratif > Art de la table > Service de table
Assiette\nA Dieppe (Seine-inférieure)	Objet décoratif > Art de la table > Service de table
Assiette\nA Moret près de Fontainebleau (Seine et Marne)	Objet décoratif > Art de la table > Service de table
Assiette\nA Sassenage (Isère)	Objet décoratif > Art de la table > Service de table
Assiette\nA Vernonet (Eure)	Objet décoratif > Art de la table > Service de table
Assiette\nA Vienne en Dauphiné (Isère)	Objet décoratif > Art de la table > Service de table
Assiette\nA Vorepe près de Grenoble	Objet décoratif > Art de la table > Service de table
Assiette\nAbbaye d'Ourscamp (Oise)	Objet décoratif > Art de la table > Service de table
Assiette\nAbbaye de Royaumont (Seine et Oise)	Objet décoratif > Art de la table > Service de table
Assiette\nAqueduc romain à Metz (Moselle)	Objet décoratif > Art de la table > Service de table
Assiette\nAu Montalet sous Meudon (Seine et Oise)	Objet décoratif > Art de la table > Service de table
Assiette\nAu parc de Morfontaine (Oise)	Objet décoratif > Art de la table > Service de table
Assiette\nBains de la Preste (Pyrenées Orientales)	Objet décoratif > Art de la table > Service de table
Assiette\nChâteau de Castels (Gironde)	Objet décoratif > Art de la table > Service de table
Assiette\nChâteau de Coeuvres (Aisne)	Objet décoratif > Art de la table > Service de table
Assiette\nChâteau de Loches (Indre et Loire)	Objet décoratif > Art de la table > Service de table
Assiette\nForêt de Fontainebleau (Seine et Marne)	Objet décoratif > Art de la table > Service de table
Assiette\nLa pompe à feu de Chaillot (Paris)	Objet décoratif > Art de la table > Service de table
Assiette\nLa rue des Trouvaires et l'église St Eustache à Paris	Objet décoratif > Art de la table > Service de table
Assiette\nLe phare de Marseille (Bouche du Rhône)	Objet décoratif > Art de la table > Service de table
Assiette\nLes bords de la Seine au bas de Meudon (Seine et Oise)	Objet décoratif > Art de la table > Service de table
Assiette\nMaison de garde à Mortefontaine	Objet décoratif > Art de la table > Service de table
Assiette\nMonument druidique à Esse près de Rennes	Objet décoratif > Art de la table > Service de table
Assiette\nRuines de l'Abbaye de Mortemer (Eure)	Objet décoratif > Art de la table > Service de table
Assiette\nRuines des Remparts de Provins (Seine et Marne)	Objet décoratif > Art de la table > Service de table
Assiette\nRuines du Château de Bilstein (Haut Rhin)	Objet décoratif > Art de la table > Service de table
Assiette\nRuines du Château de Morimont (Haut Rhin)	Objet décoratif > Art de la table > Service de table
Assiette\nRuines du Château de la Ferté-Milon (Aisne)	Objet décoratif > Art de la table > Service de table
Assiette\nRuines du château d'Alluye (Eure et Loire)"	Objet décoratif > Art de la table > Service de table
Assiette\nSt Sulpice à Pierrefonds (Oise)	Objet décoratif > Art de la table > Service de table
Assiette\nTour de Buffon à Montbard (côte d'Or)	Objet décoratif > Art de la table > Service de table
Assiette\nVue de Rennes (Ile et Vilaine)	Objet décoratif > Art de la table > Service de table
Assiette\nVue de Thiers (Puy de Dôme)	Objet décoratif > Art de la table > Service de table
Assiette\nVue du Château de Combourg (lle et Vilaine)	Objet décoratif > Art de la table > Service de table
Assiette\nVue du Château de Gisors (Eure)	Objet décoratif > Art de la table > Service de table
Assiette\nVue du Château de Loches (Indre et Loire)	Objet décoratif > Art de la table > Service de table
Assiette\nVue prise à Marseille (Bouche du Rhône)	Objet décoratif > Art de la table > Service de table
Assiette\nVue prise à St Ouen (Seine)	Objet décoratif > Art de la table > Service de table
Assiette\nYerville (Seine inférieure)	Objet décoratif > Art de la table > Service de table
Assiette creuse	Objet décoratif > Art de la table > Service de table
Assiette de surtout de table montée transformée en lampe	Objet décoratif > Art de la table > Service de table
Assiette plate	Objet décoratif > Art de la table > Service de table
Assiette à dessert	Objet décoratif > Art de la table > Service de table
Assiette à fromage	Objet décoratif > Art de la table > Service de table
Couteau	Objet décoratif > Art de la table > Service de table
Couteau à entremets	Objet décoratif > Art de la table > Service de table
Cuillère	Objet décoratif > Art de la table > Service de table
Cuillère à café	Objet décoratif > Art de la table > Service de table
Fourchette	Objet décoratif > Art de la table > Service de table
SERVICE DE TABLE	Objet décoratif > Art de la table > Service de table
Service à thé\nDessus de plateau	Objet décoratif > Art de la table > Service à thé et à café
Service à thé\nNappe	Objet décoratif > Art de la table > Service à thé et à café
Service à thé\nNappe\n	Objet décoratif > Art de la table > Service à thé et à café
Service à thé\nRond	Objet décoratif > Art de la table > Service à thé et à café
Service à thé\nServiette	Objet décoratif > Art de la table > Service à thé et à café
Service à thé\nServiettes	Objet décoratif > Art de la table > Service à thé et à café
Service à thé\nServiettes\n	Objet décoratif > Art de la table > Service à thé et à café
Service à thé \nPlateau	Objet décoratif > Art de la table > Service à thé et à café
Service à thé \nPot à lait	Objet décoratif > Art de la table > Service à thé et à café
Service à thé \nSucrier	Objet décoratif > Art de la table > Service à thé et à café
Service à thé - Théière	Objet décoratif > Art de la table > Service à thé et à café
Service à thé Les Roses\nNappe	Objet décoratif > Art de la table > Service à thé et à café
Service à thé Les Roses\nServiette	Objet décoratif > Art de la table > Service à thé et à café
Service à thé Pompadour carrés\nNappe	Objet décoratif > Art de la table > Service à thé et à café
Service à thé Pompadour carrés\nServiette	Objet décoratif > Art de la table > Service à thé et à café
Service à thé Pompadour coeur\nNappe	Objet décoratif > Art de la table > Service à thé et à café
Service à thé Pompadour coeur\nServiette	Objet décoratif > Art de la table > Service à thé et à café
Service à thé Pompadour feuillage\nNappe	Objet décoratif > Art de la table > Service à thé et à café
Service à thé Pompadour feuillage\nServiette	Objet décoratif > Art de la table > Service à thé et à café
Service à thé Pompadour fleur\nNappe	Objet décoratif > Art de la table > Service à thé et à café
Service à thé Pompadour fleur\nServiette	Objet décoratif > Art de la table > Service à thé et à café
Service à thé Pompadour rond\nNappe	Objet décoratif > Art de la table > Service à thé et à café
Service à thé Pompadour rond\nServiette	Objet décoratif > Art de la table > Service à thé et à café
Service à thé Pâquerettes et Boutons de Roses\nNappe	Objet décoratif > Art de la table > Service à thé et à café
Service à thé Pâquerettes et Boutons de Roses\nServiette	Objet décoratif > Art de la table > Service à thé et à café
Service à thé Pâquerettes et Boutons de Roses\nServiettes	Objet décoratif > Art de la table > Service à thé et à café
Service à thé et à café\nCafetière	Objet décoratif > Art de la table > Service à thé et à café
Service à thé et à café\nPlateau	Objet décoratif > Art de la table > Service à thé et à café
Service à thé et à café\nPot à lair	Objet décoratif > Art de la table > Service à thé et à café
Service à thé et à café\nPot à lait	Objet décoratif > Art de la table > Service à thé et à café
Service à thé et à café\nSucrier	Objet décoratif > Art de la table > Service à thé et à café
Service à thé et à café\nThéière	Objet décoratif > Art de la table > Service à thé et à café
Table de décharge	Meuble > Table > Table d'appoint
Bibliothèque basse	Meuble > Rangement > Bibliothèque
Paravent	Meuble > Paravent et écran > Paravent
Paravent\nFenêtre ouverte sur la mer	Meuble > Paravent et écran > Paravent
Paravent 12 feuilles\nDECOR FLEURI NOIR	Meuble > Paravent et écran > Paravent
Paravent 2 feuilles	Meuble > Paravent et écran > Paravent
Paravent 3 feuilles	Meuble > Paravent et écran > Paravent
Paravent 3 feuilles\nDECOR A FOND CREME	Meuble > Paravent et écran > Paravent
Paravent 3 feuilles\nDEESSES	Meuble > Paravent et écran > Paravent
Paravent 3 feuilles\nPEINTURE SUR CARTON	Meuble > Paravent et écran > Paravent
Paravent 4 feuilles	Meuble > Paravent et écran > Paravent
Paravent 4 feuilles\nAUBUSSON EYNARD	Meuble > Paravent et écran > Paravent
Paravent 4 feuilles\nBEAUVAIS	Meuble > Paravent et écran > Paravent
Paravent 4 feuilles\nBOIS PLEIN RECTILIGN	Meuble > Paravent et écran > Paravent
Paravent 4 feuilles\nFOND ECAILLE BRUNE	Meuble > Paravent et écran > Paravent
Paravent 4 feuilles\nFleurs des champs	Meuble > Paravent et écran > Paravent
Paravent 4 feuilles\nLes Faisans	Meuble > Paravent et écran > Paravent
Paravent 4 feuilles\nP.V. VENTE 33 96/0592/142\nARRETE DU 10.02.1997\n	Meuble > Paravent et écran > Paravent
Paravent 4 feuilles\nPAYSAGE MARITIME	Meuble > Paravent et écran > Paravent
Paravent 5 feuilles	Meuble > Paravent et écran > Paravent
Paravent 5 feuilles\nFOND VIEUX ROSE	Meuble > Paravent et écran > Paravent
Paravent 5 feuilles\nSYCOMORE\nDEVENU N° D'INVENTAIRE SUIVANT GMT 13764	Meuble > Paravent et écran > Paravent
Paravent 6 feuilles	Meuble > Paravent et écran > Paravent
Paravent 6 feuilles\nBEAUVAIS	Meuble > Paravent et écran > Paravent
Paravent 6 feuilles\nGLACE BISEAUTEE	Meuble > Paravent et écran > Paravent
Paravent 6 feuilles\nGOBELINS	Meuble > Paravent et écran > Paravent
Paravent 8 feuilles	Meuble > Paravent et écran > Paravent
Paravent double face	Meuble > Paravent et écran > Paravent
Paravent double face , 4 feuilles en tapisserie	Meuble > Paravent et écran > Paravent
Paravent en triptyque : Fenêtre sur cour	Meuble > Paravent et écran > Paravent
Paravent en triptyque: Fenêtre sur cour	Meuble > Paravent et écran > Paravent
Paravent à 3 feuilles	Meuble > Paravent et écran > Paravent
Paravent à 4 feuilles	Meuble > Paravent et écran > Paravent
Paravent à 4 feuilles\nDécision de radiation n°2011/8 du 09/09/2011	Meuble > Paravent et écran > Paravent
Paravent à 4 feuilles.\nCommission de Contrôle du 27 janvier 2016.	Meuble > Paravent et écran > Paravent
Paravent à 5 feuilles	Meuble > Paravent et écran > Paravent
Paravent à 6 feuilles	Meuble > Paravent et écran > Paravent
Paravent à quatre feuilles	Meuble > Paravent et écran > Paravent
Glace	Meuble > Miroir
Glace 3 faces	Meuble > Miroir
Glace argentée	Meuble > Miroir
Glace clair	Meuble > Miroir
Glace d'applique	Meuble > Miroir
Glace de cheminée	Meuble > Miroir
Glace de cheminée avec cadre à fond creux	Meuble > Miroir
Glace de cheminée et plâtre doré	Meuble > Miroir
Glace de cheminée. P.V. VENTE 17 2002-FEV-0065\nARRETE DU 07.06.2002	Meuble > Miroir
Glace de coiffeuse	Meuble > Miroir
Glace de table (portative)	Meuble > Miroir
Glace murale	Meuble > Miroir
Glace murale	Meuble > Miroir
Glace murale argentée	Meuble > Miroir
Glace murale argentée biseautée	Meuble > Miroir
Glace murale avec bois moulure	Meuble > Miroir
Glace ovale	Meuble > Miroir
Glace portative argentée	Meuble > Miroir
Glace portative argentée	Meuble > Miroir
Glace à fond noir	Meuble > Miroir
Miroir	Meuble > Miroir
Miroir Lago Dorato	Meuble > Miroir
Miroir Lago Dorato argent	Meuble > Miroir
Miroir Lago Dorato doré	Meuble > Miroir
Miroir de cheminée	Meuble > Miroir
Miroir mural	Meuble > Miroir
Miroir mural à 6 panneaux	Meuble > Miroir
Miroir ovale sur pieds	Meuble > Miroir
Miroir à fronton	Meuble > Miroir
Miroir à main	Meuble > Miroir
Miroir à patins	Meuble > Miroir
Miroir à trumeau	Meuble > Miroir
Mise au tombeau	Meuble > Miroir
Lit de travers	Meuble > Lit > Lit de travers
Lit de travers à baldaquin	Meuble > Lit > Lit de travers
Secrétaire deux portes	Meuble > Bureau > Secrétaire
Secrétaire en armoire	Meuble > Bureau > Secrétaire
Secrétaire en pente	Meuble > Bureau > Secrétaire
Secrétaire à abattan	Meuble > Bureau > Secrétaire
Secrétaire à abattant	Meuble > Bureau > Secrétaire
Secrétaire à abattant\nDécision de radiation n°2008/8 suite à la vente du 11/12/2008	Meuble > Bureau > Secrétaire
Secrétaire à abattant\nDécision de transfert d'affectation n° 2005/18 du 14.10.2005	Meuble > Bureau > Secrétaire
Secrétaire à abattant\nMARQUE BIS PAR ERREUR	Meuble > Bureau > Secrétaire
Secrétaire à abattant\nRetiré de la vente en 2009.	Meuble > Bureau > Secrétaire
Secrétaire à abattant	Meuble > Bureau > Secrétaire
Secrétaire à abattant bas	Meuble > Bureau > Secrétaire
Secrétaire à abattant. Décision de radiation n°2008/8 suite à la vente du 11/12/2008	Meuble > Bureau > Secrétaire
Secrétaire à abattant. Décision de radiation n°2009/4 du 17/07/2009 suite à la vente du 3/07/2009	Meuble > Bureau > Secrétaire
Secrétaire à abattant. Décision de transfert d'affectation n° 2005/12	Meuble > Bureau > Secrétaire
Secrétaire à abattant. Décision de transfert d'affectation n° 2005/19 du 20.10.2005	Meuble > Bureau > Secrétaire
Secrétaire à abattant. Décision de transfert d'affectation n° 2005/6	Meuble > Bureau > Secrétaire
Secrétaire à abattant. RADIATION DES INVENTAIRES \nARRETE DU 16.05.1989\nMINISTERE JEUNESSE & SPORTS	Meuble > Bureau > Secrétaire
Secrétaire à abattant. RADIATION DES INVENTAIRES \nARRETE DU 29.09.1986\nMINISTERE DE L'AGRICULTURE	Meuble > Bureau > Secrétaire
Secrétaire à abattant. RADIATION DES INVENTAIRES \nARRETE DU 12.01.1985\nAMBASSADE A MOSCOU	Meuble > Bureau > Secrétaire
Secrétaire à cabinet	Meuble > Bureau > Secrétaire
Secrétaire à cylindre	Meuble > Bureau > Secrétaire
Secrétaire à cylindre à dessus plein	Meuble > Bureau > Secrétaire
Secrétaire à deux abattants	Meuble > Bureau > Secrétaire
Secrétaire à pente	Meuble > Bureau > Secrétaire
Secrétaire à volet	Meuble > Bureau > Secrétaire
Secrétaire-armoire	Meuble > Bureau > Secrétaire
Secrétaitre à abattant	Meuble > Bureau > Secrétaire
Bureau	Meuble > Bureau
Bureau\nDécision de radiation n° 2004/14\nsuite à la vente du 9 décembre 2004	Meuble > Bureau
Bureau	Meuble > Bureau
Bureau \nDécision de radiation n° 2004/14\nsuite à la vente du 9 décembre 2004	Meuble > Bureau
Bureau "surpiqure"	Meuble > Bureau
Bureau (dit de Le Brun)	Meuble > Bureau
Bureau C.E.O Cube	Meuble > Bureau
Bureau Grekko	Meuble > Bureau
Bureau Mazarin	Meuble > Bureau
Bureau avec retour	Meuble > Bureau
Bureau chemin de fer	Meuble > Bureau
Bureau chemin de fer à gradin	Meuble > Bureau
Bureau conférence\nDécision de radiation n° 2005/4\nsuite à la vente du 26 mai 2005	Meuble > Bureau
Bureau d'homme	Meuble > Bureau
Bureau d'huissier	Meuble > Bureau
Bureau dactylo\nDécision de radiation n°2010/2 du 13.12.2010 pour destruction	Meuble > Bureau
Bureau dactylo\nDécision de radiation n°2013/02 du 28.03.2013 pour destruction	Meuble > Bureau
Bureau de dame	Meuble > Bureau
Bureau de dame\nRADIATION DES INVENTAIRES \nARRETE DU 11.10.1977	Meuble > Bureau
Bureau de dame\nRADIATION DES INVENTAIRES ARRETE DU 30.03.1990 S.H.A.P.E. MARNES LA COQUETTE	Meuble > Bureau
Bureau de dame ou bonheur du jour	Meuble > Bureau
Bureau de direction\n"Mast"	Meuble > Bureau
Bureau demi-ministre	Meuble > Bureau
Bureau demi-ministre\nDécision de radiation 2008/3 du 04/06/2008	Meuble > Bureau
Bureau demi-ministre\nP.V. REBUT 10 93/0887\nARRETE DU 29.04.1993	Meuble > Bureau
Bureau demi-ministre\nP.V. REBUT 13 2000-SEP-0043\nARRETE DU 05.09.2000	Meuble > Bureau
Bureau demi-ministre\nP.V. REBUT 14 94/0223\nARRETE DU 12.10.1993	Meuble > Bureau
Bureau demi-ministre\nP.V. REBUT 19 94/1808\nARRETE DU 19.12.1994	Meuble > Bureau
Bureau dos d'âne	Meuble > Bureau
Bureau double face	Meuble > Bureau
Bureau démontable	Meuble > Bureau
Bureau gigogne	Meuble > Bureau
Bureau ministre	Meuble > Bureau
Bureau ministre\nDECISION DE RADIATION 2004/1\nPOUR DESTRUCTION	Meuble > Bureau
Bureau ministre\nDécision de radiation N° 2004/8 suite à la vente du 8/07/2004	Meuble > Bureau
Bureau ministre\nDécision de radiation n° 2011/5 du 08-07-2011 suite à la vente du 28/06/2011	Meuble > Bureau
Bureau ministre\nEn remplacement du bureau GME 7144	Meuble > Bureau
Bureau ministre\nP.V. REBUT 16 2001-JUN-0223\nARRETE DU 27.06.2001	Meuble > Bureau
Bureau ministre\nP.V. REBUT 16 94/0223\nARRETE DU 11.01.1994	Meuble > Bureau
Bureau ministre\nP.V. VENTE 05 99/1014\nARRETE DU 29.07.1999	Meuble > Bureau
Bureau ministre\nP.V. VENTE 10 1999/déc./0187\nARRETE DU 17.02.2000\n	Meuble > Bureau
Bureau ministre\nP.V. VENTE 22 2002-OCT-0391\nARRETE DU 30.12.2002	Meuble > Bureau
Bureau ministre\nP.V. VENTE 3* 92/1569 INVENDU\nARRETE DU 29.01.1993	Meuble > Bureau
Bureau ministre\nP.V. VENTE 33 96/0592/142\nARRETE DU 10.02.1997	Meuble > Bureau
Bureau ministre\nP.V. VENTE 44 97/1408\nARRETE DU 09.02.98\n	Meuble > Bureau
Bureau ministre\nP.V. VENTE 47 97/2075\nARRETE DU 09.02.98\n	Meuble > Bureau
Bureau ministre\nP.V. VENTE 47 97/2075 REFUSE\nREBUT 51 ARRETE DU 16.04.98	Meuble > Bureau
Bureau ministre\nP.V. VENTE 50 98/0664-1\nARRETE DU 10.07.1998	Meuble > Bureau
Bureau ministre\nP.V. VENTE 50 98/0664-1\nINVENDU - REBUT - P.V. 56\nARRETE DU 07.09.1998\n	Meuble > Bureau
Bureau ministre\nP.V. VENTE 55 98/1195\nARRETE DU 17.08.98	Meuble > Bureau
Bureau ministre\nP.V. VENTE 60 98/2491\nARRETE DU 16.02.1999	Meuble > Bureau
Bureau ministre\nRADIATION DES INVENTAIRES \nARRETE DU 08.10.1990\nMINISTERE DE LA DEFENSE	Meuble > Bureau
Bureau ministre\nRADIATION DES INVENTAIRES ARRETE DU 30.03.1990 S.H.A.P.E. MARNES LA COQUETTE	Meuble > Bureau
Bureau ministre double face	Meuble > Bureau
Bureau mécanique	Meuble > Bureau
Bureau métallique	Meuble > Bureau
Bureau plat	Meuble > Bureau
Bureau plat\n13051991 RADIATION DES INVENTAIRES DU MOBILIER NATIONAL * PAR ARRETE MINISTERIEL* MINIS	Meuble > Bureau
Bureau plat\nDécision de radiation N° 2004/8 suite à la vente du 8/07/2004	Meuble > Bureau
Bureau plat\nDécision de radiation n° 2004/14\nsuite à la vente du 9 décembre 2004	Meuble > Bureau
Bureau plat\nDécision de radiation n° 2005/4\nsuite à la vente du 26 mai 2005	Meuble > Bureau
Bureau plat\nDécision de radiation n° 2005/6\nsuite à la vente du 29 septembre 2005	Meuble > Bureau
Bureau plat\nDécision de transfert d'affectation n° 2005/16	Meuble > Bureau
Bureau plat\nModèle Washington	Meuble > Bureau
Bureau plat\nModèle Washington PROBLEME\nil n'y a que 2 bureaux achetés, cf livre d'Inv	Meuble > Bureau
Bureau plat\nP.V. VENTE 10 1999/déc./0187\nARRETE DU 17.02.2000\n	Meuble > Bureau
Bureau plat\nP.V. VENTE 33 96/0592/142\nARRETE DU 10.02.1997	Meuble > Bureau
Bureau plat\nP.V. VENTE 60 98/2491\nARRETE DU 16.02.1999	Meuble > Bureau
Bureau plat\nmodèle Diégo	Meuble > Bureau
Bureau plat à caissons	Meuble > Bureau
Bureau plat. Modèle Washington	Meuble > Bureau
Bureau pupitre	Meuble > Bureau
Bureau pupitre Scriban	Meuble > Bureau
Bureau suspendu	Meuble > Bureau
Bureau table	Meuble > Bureau
Bureau à caisson	Meuble > Bureau
Bureau à caissons	Meuble > Bureau
Bureau à cylindre	Meuble > Bureau > Bureau à cylindre
Bureau à cylindre\nDécision de radiation n° 2011/5 du 08-07-2011 suite à la vente du 28/06/2011	Meuble > Bureau > Bureau à cylindre
Bureau à cylindre\nDécision de radiation n°2008/8 suite à la vente du 11/12/2008	Meuble > Bureau > Bureau à cylindre
Bureau à cylindre avec armoire	Meuble > Bureau > Bureau à cylindre
Bureau à gradin	Meuble > Bureau
Bureau à gradin\nP.V. VENTE 05 99/1014\nARRETE DU 29.07.1999	Meuble > Bureau
Bureau à retour	Meuble > Bureau
Bureau à tiroirs	Meuble > Bureau
Bureau à transformation	Meuble > Bureau
Poudreuse	Meuble
Lustre	Luminaire > Lustre et plafonnier > Lustre
Lustre 1 lumière	Luminaire > Lustre et plafonnier > Lustre
Lustre 12 lumières	Luminaire > Lustre et plafonnier > Lustre
Lustre 12 lumières avec fausses bougies	Luminaire > Lustre et plafonnier > Lustre
Lustre 12 lumières en verre de Venise	Luminaire > Lustre et plafonnier > Lustre
Lustre 12 lumières en verre de venise	Luminaire > Lustre et plafonnier > Lustre
Lustre 15 lumières avec sphère à facettes	Luminaire > Lustre et plafonnier > Lustre
Lustre 16 lumières	Luminaire > Lustre et plafonnier > Lustre
Lustre 16 lumières avec coupe à godrons	Luminaire > Lustre et plafonnier > Lustre
Lustre 18 lumières	Luminaire > Lustre et plafonnier > Lustre
Lustre 18 lumières de genre hollandais	Luminaire > Lustre et plafonnier > Lustre
Lustre 20 lumières	Luminaire > Lustre et plafonnier > Lustre
Lustre 20 lumières avec vase à perles godrons	Luminaire > Lustre et plafonnier > Lustre
Lustre 24 lumières	Luminaire > Lustre et plafonnier > Lustre
Lustre 30 lumières avec fausses bougies	Luminaire > Lustre et plafonnier > Lustre
Lustre 4 lumières	Luminaire > Lustre et plafonnier > Lustre
Lustre 4 lumières avec vase surmonté tige	Luminaire > Lustre et plafonnier > Lustre
Lustre 4 lumières en fer et cristaux	Luminaire > Lustre et plafonnier > Lustre
Lustre 4 lumières équipé	Luminaire > Lustre et plafonnier > Lustre
Lustre 6 lumières	Luminaire > Lustre et plafonnier > Lustre
Lustre 6 lumières avec couronne circulaire	Luminaire > Lustre et plafonnier > Lustre
Lustre 6 lumières avec fausses bougies	Luminaire > Lustre et plafonnier > Lustre
Lustre 6 lumières avec tole laquée noire	Luminaire > Lustre et plafonnier > Lustre
Lustre 6 lumières avec tole laquée verte	Luminaire > Lustre et plafonnier > Lustre
Lustre 8 lumières	Luminaire > Lustre et plafonnier > Lustre
Lustre 8 lumières/branches + 4 douilles.	Luminaire > Lustre et plafonnier > Lustre
Lustre 9 lumières équipé	Luminaire > Lustre et plafonnier > Lustre
Lustre Saturne	Luminaire > Lustre et plafonnier > Lustre
Lustre Tourbillon	Luminaire > Lustre et plafonnier > Lustre
Lustre de billard	Luminaire > Lustre et plafonnier > Lustre
Lustre pour le restaurant du Louvre Abu Dhabi	Luminaire > Lustre et plafonnier > Lustre
Lustre à 1 lumière	Luminaire > Lustre et plafonnier > Lustre
Lustre à 10 lumières	Luminaire > Lustre et plafonnier > Lustre
Lustre à 11 lumières	Luminaire > Lustre et plafonnier > Lustre
Lustre à 12 lumières	Luminaire > Lustre et plafonnier > Lustre
Lustre à 12 lumières\nDécision de radiation 2016/03 du 28/02/2016 pour double prise à l'inventaire (	Luminaire > Lustre et plafonnier > Lustre
Lustre à 12 lumières\nSUJETS MYTHOLOGIQUES	Luminaire > Lustre et plafonnier > Lustre
Lustre à 12 lumières, sur deux gradations	Luminaire > Lustre et plafonnier > Lustre
Lustre à 15 lumières	Luminaire > Lustre et plafonnier > Lustre
Lustre à 16 lumières	Luminaire > Lustre et plafonnier > Lustre
Lustre à 16 lumières\nRADIATION DES INVENTAIRES \nARRETE DU 11.10.1977\nCHATEAU DE VIZILLE	Luminaire > Lustre et plafonnier > Lustre
Lustre à 17 lumières	Luminaire > Lustre et plafonnier > Lustre
Lustre à 18 lumières	Luminaire > Lustre et plafonnier > Lustre
Lustre à 20 lumières	Luminaire > Lustre et plafonnier > Lustre
Lustre à 22 lumières	Luminaire > Lustre et plafonnier > Lustre
Lustre à 24 lumières	Luminaire > Lustre et plafonnier > Lustre
Lustre à 24 lumières\nRADIATION DES INVENTAIRES \nARRETE DU 11.10.1977\nCHATEAU DE VIZILLE	Luminaire > Lustre et plafonnier > Lustre
Lustre à 27 lumières	Luminaire > Lustre et plafonnier > Lustre
Lustre à 28 lumières	Luminaire > Lustre et plafonnier > Lustre
Lustre à 3 lumières	Luminaire > Lustre et plafonnier > Lustre
Lustre à 3 lumières\nRADIATION DES INVENTAIRES \nARRETE DU 11.10.1977\nCHATEAU DE VIZILLE	Luminaire > Lustre et plafonnier > Lustre
Lustre à 30 lumières	Luminaire > Lustre et plafonnier > Lustre
Lustre à 30 lumières.	Luminaire > Lustre et plafonnier > Lustre
Lustre à 32 lumières	Luminaire > Lustre et plafonnier > Lustre
Lustre à 33 lumières	Luminaire > Lustre et plafonnier > Lustre
Lustre à 35 lumières	Luminaire > Lustre et plafonnier > Lustre
Lustre à 36 lumières	Luminaire > Lustre et plafonnier > Lustre
Lustre à 38 lumières	Luminaire > Lustre et plafonnier > Lustre
Lustre à 39 lumières	Luminaire > Lustre et plafonnier > Lustre
Lustre à 4 lumières	Luminaire > Lustre et plafonnier > Lustre
Lustre à 40 lumières	Luminaire > Lustre et plafonnier > Lustre
Lustre à 40 lumières et 5 lampes	Luminaire > Lustre et plafonnier > Lustre
Lustre à 44 lumières	Luminaire > Lustre et plafonnier > Lustre
Lustre à 45 lumières	Luminaire > Lustre et plafonnier > Lustre
Lustre à 48 lumières	Luminaire > Lustre et plafonnier > Lustre
Lustre à 5 lumières	Luminaire > Lustre et plafonnier > Lustre
Lustre à 5 lumières\nRADIATION DES INVENTAIRES \nARRETE du 08.10.1990\nMINISTERE DE LA DEFENSE	Luminaire > Lustre et plafonnier > Lustre
Lustre à 52 lumières	Luminaire > Lustre et plafonnier > Lustre
Lustre à 54 lumières	Luminaire > Lustre et plafonnier > Lustre
Lustre à 56 lumières	Luminaire > Lustre et plafonnier > Lustre
Lustre à 6 lumières	Luminaire > Lustre et plafonnier > Lustre
Lustre à 6 lumières\nDécision de radiation 2016/03 du 01/07/2016 pour double prise à l'inventaire (G	Luminaire > Lustre et plafonnier > Lustre
Lustre à 6 lumières\nDécision de radiation 2016/03 du 01/07/2016 pour double prise à l'inventaire (G	Luminaire > Lustre et plafonnier > Lustre
Lustre à 6 lumières\nDécision de radiation 2016/03 du 01/07/2016 pour double prise à l'inventaire (G	Luminaire > Lustre et plafonnier > Lustre
Lustre à 6 lumières\nDécision de radiation 2016/03 du 01/07/2016 pour double prise à l'inventaire (G	Luminaire > Lustre et plafonnier > Lustre
Lustre à 6 lumières\npris par erreur, Inventaire A de Fontainebleau, restitution le 04/12/2007 à Fon	Luminaire > Lustre et plafonnier > Lustre
Lustre à 6 lumières, \nDécision de radiation 2016/02 du 19/02/2016 pour double prise à l'inventaire	Luminaire > Lustre et plafonnier > Lustre
Lustre à 60 lumières	Luminaire > Lustre et plafonnier > Lustre
Lustre à 64 lumières	Luminaire > Lustre et plafonnier > Lustre
Lustre à 68 lumières	Luminaire > Lustre et plafonnier > Lustre
Lustre à 7 lumières	Luminaire > Lustre et plafonnier > Lustre
Lustre à 70 lumières	Luminaire > Lustre et plafonnier > Lustre
Lustre à 8 lumières	Luminaire > Lustre et plafonnier > Lustre
Lustre à 8 lumières\nDécision de radiation 2016/03 du 01/07/2016 pour double prise à l'inventaire (G	Luminaire > Lustre et plafonnier > Lustre
Lustre à 8 lumières\nRADIATION DES INVENTAIRES ARRETE DU 30.03.1990 S.H.A.P.E. MARNES LA COQUETTE	Luminaire > Lustre et plafonnier > Lustre
Lustre à 8 lumières	Luminaire > Lustre et plafonnier > Lustre
Lustre à 84 lumières\nRADIATION DES INVENTAIRES\nARRETE DU 08.09.1982\nAMBASSADE A ANKARA	Luminaire > Lustre et plafonnier > Lustre
Lustre à 9 lumières	Luminaire > Lustre et plafonnier > Lustre
Lustre à douze lumières	Luminaire > Lustre et plafonnier > Lustre
Lanterne	Luminaire > Lanterne
Lanterne 1 lumière	Luminaire > Lanterne
Lanterne 3 lumières	Luminaire > Lanterne
Lanterne 3 lumières (équipée)	Luminaire > Lanterne
Lanterne 3 lumières en forme cylindrique	Luminaire > Lanterne
Lanterne 3 lumières et 3 panneaux	Luminaire > Lanterne
Lanterne 4 lumières	Luminaire > Lanterne
Lanterne 4 lumières (équipée)	Luminaire > Lanterne
Lanterne 4 lumières. Tambour à 4 vitres.	Luminaire > Lanterne
Lanterne 5 lumières	Luminaire > Lanterne
Lanterne 5 lumières et fausses bougies	Luminaire > Lanterne
Lanterne 5 lumières et fausses bougies	Luminaire > Lanterne
Lanterne 6 lumières	Luminaire > Lanterne
Lanterne 9 lumières	Luminaire > Lanterne
Lanterne Magique	Luminaire > Lanterne
Lanterne cage	Luminaire > Lanterne
Lanterne murale	Luminaire > Lanterne
Lanterne ronde	Luminaire > Lanterne
Lanterne rouge	Luminaire > Lanterne
Lanterne vitrée	Luminaire > Lanterne
Lanterne à 1 lumière	Luminaire > Lanterne
Lanterne à 1 lumière.	Luminaire > Lanterne
Lanterne à 12 lumières	Luminaire > Lanterne
Lanterne à 2 lumières	Luminaire > Lanterne
Lanterne à 3 lumières	Luminaire > Lanterne
Lanterne à 3 lumières-Décision de radiation 2014/05 du 11/08/2014 pour double prise à l'inventaire G	Luminaire > Lanterne
Lanterne à 4 lumières	Luminaire > Lanterne
Lanterne à 4 lumières-Décision de radiation 2018/03 du 18/04/2018 pour double prise à l'inventaire G	Luminaire > Lanterne
Lanterne à 5 lumières	Luminaire > Lanterne
Lanterne à 6 lumières	Luminaire > Lanterne
Lanterne à 7 lumières	Luminaire > Lanterne
Lanterne à 8 lumières	Luminaire > Lanterne
Lanterne à 9 Lumières	Luminaire > Lanterne
Lanterne à main	Luminaire > Lanterne
Lanterne à quatre lumières	Luminaire > Lanterne
Lanterne à trois lumières	Luminaire > Lanterne
Lampe bouillotte	Luminaire > Lampe > Lampe de bureau
Lampe bouillotte	Luminaire > Lampe > Lampe de bureau
Lampe bouillotte à 1 lumière	Luminaire > Lampe > Lampe de bureau
Lampe bouillotte à 2 lumières	Luminaire > Lampe > Lampe de bureau
Lampe bouillotte à 3 Lumières	Luminaire > Lampe > Lampe de bureau
Lampe bouillotte à 3 lumières	Luminaire > Lampe > Lampe de bureau
Lampe bouillotte à 3 lumières\nrayé des inventaires du mobilier national par arrêté ministériel du 3	Luminaire > Lampe > Lampe de bureau
Lampe bouillotte à 4 lumières	Luminaire > Lampe > Lampe de bureau
Lampe bouillotte à 6 lumières	Luminaire > Lampe > Lampe de bureau
Lampe bouillotte à cinq lumières	Luminaire > Lampe > Lampe de bureau
Lampe bouillotte à trois lumières	Luminaire > Lampe > Lampe de bureau
Lampe de bureau	Luminaire > Lampe > Lampe de bureau
Lampe de bureau\n	Luminaire > Lampe > Lampe de bureau
Lampe de bureau\n"Tabla"	Luminaire > Lampe > Lampe de bureau
Lampe de bureau\nAbat-jour Bakelite	Luminaire > Lampe > Lampe de bureau
Lampe de bureau\nDécision de radiation 2008/3 du 04/06/2008	Luminaire > Lampe > Lampe de bureau
Lampe de bureau\nDécision de radiation n° 2004/5\nAbandon	Luminaire > Lampe > Lampe de bureau
Lampe de bureau\nDécision de radiation n°2018/01 du 30/01/2018 pour destruction\n(motif : mis au reb	Luminaire > Lampe > Lampe de bureau
Lampe de bureau\nModèle Evasion	Luminaire > Lampe > Lampe de bureau
Lampe de bureau\nModèle Fritz	Luminaire > Lampe > Lampe de bureau
Lampe de bureau\nModèle Gédéon	Luminaire > Lampe > Lampe de bureau
Lampe de bureau\nModèle TIZIO	Luminaire > Lampe > Lampe de bureau
Lampe de bureau\nModèle Tizio	Luminaire > Lampe > Lampe de bureau
Lampe de bureau\nModèle Uau	Luminaire > Lampe > Lampe de bureau
Lampe de bureau\nMulti X	Luminaire > Lampe > Lampe de bureau
Lampe de bureau\nP.V. REBUT 15 2001-FEV-0032\nARRETE DU 27.02.2001	Luminaire > Lampe > Lampe de bureau
Lampe de bureau\nP.V. REBUT 5* 93/0887\nARRETE DU 22.09.1992	Luminaire > Lampe > Lampe de bureau
Lampe de bureau\nmodèle Tabla	Luminaire > Lampe > Lampe de bureau
Lampe de bureau 1 lumière	Luminaire > Lampe > Lampe de bureau
Lampe de bureau 2 lumières	Luminaire > Lampe > Lampe de bureau
Lampe de bureau 5 lumières	Luminaire > Lampe > Lampe de bureau
Lampe de bureau B 29	Luminaire > Lampe > Lampe de bureau
Lampe de bureau Bérénice	Luminaire > Lampe > Lampe de bureau
Lampe de bureau Daphine	Luminaire > Lampe > Lampe de bureau
Lampe de bureau halogène	Luminaire > Lampe > Lampe de bureau
Lampe de bureau, modèle Manade	Luminaire > Lampe > Lampe de bureau
Lampe de chevet	Luminaire > Lampe  > Lampe de chevet
Lampe de chevet\n	Luminaire > Lampe  > Lampe de chevet
Lampe de chevet\n(dévidoir transformé)	Luminaire > Lampe  > Lampe de chevet
Lampe de chevet\nABAT-JOUR BLANC	Luminaire > Lampe  > Lampe de chevet
Lampe de chevet\nMOULURE EN CAVET	Luminaire > Lampe  > Lampe de chevet
Lampe de chevet\nModèle "Pao 2"	Luminaire > Lampe  > Lampe de chevet
Lampe de chevet\nSPHERE EN LACET CUIR	Luminaire > Lampe  > Lampe de chevet
Lampe de chevet, bougeoir une lumière.	Luminaire > Lampe  > Lampe de chevet
Vase monte en lampe	Luminaire > Lampe
Vase monté en lampe	Luminaire > Lampe
Vase monté en lampe 3 lumières	Luminaire > Lampe
Vase monté en lampe à 2 lumières	Luminaire > Lampe
Vase monté en lampe.\nRADIATION DES INVENTAIRES \nARRETE DU 17.11.1981 \nSECRETARIAT D ETAT TRANSPO	Luminaire > Lampe
Lampadaire 2 lumières avec abat jour en toile	Luminaire > Lampadaire
Lampadaire 3 lampes avec abat-jour blanc	Luminaire > Lampadaire
Lampadaire 3 lumières	Luminaire > Lampadaire
Lampadaire 3 lumières\nCommission de Contrôle du 27 janvier 2016.	Luminaire > Lampadaire
Lampadaire 4 lumières	Luminaire > Lampadaire
Lampadaire 4 lumières avec abat-jour en laiton	Luminaire > Lampadaire
Lampadaire Carrara	Luminaire > Lampadaire
Lampadaire Quadra	Luminaire > Lampadaire
Lampadaire Spun Light	Luminaire > Lampadaire
Lampadaire Star	Luminaire > Lampadaire
Lampadaire de rampe d'escalier	Luminaire > Lampadaire
Lampadaire halogène	Luminaire > Lampadaire
Lampadaire halogène\nBASE PLATE CIRCULAIR	Luminaire > Lampadaire
Lampadaire halogène\nDécision de radiation n°2018/01 du 30/01/2018 pour destruction\n(motif : mis au	Luminaire > Lampadaire
Lampadaire porte-lampe	Luminaire > Lampadaire
Lampadaire à 2 Lumières	Luminaire > Lampadaire
Lampadaire à 2 Lumières\nCommission de Contrôle du 27 janvier 2016.	Luminaire > Lampadaire
Lampadaire à 2 lumières	Luminaire > Lampadaire
Lampadaire à 2 lumières\nCommission de Contrôle du 27 janvier 2016.	Luminaire > Lampadaire
Lampadaire à 3 Lumières	Luminaire > Lampadaire
Lampadaire à 3 lumières	Luminaire > Lampadaire
Lampadaire à 3 lumières\nCommission de Contrôle du 27 janvier 2016.	Luminaire > Lampadaire
Lampadaire à 3 lumières\nDécision de radiation n°2008/4 du 16/06/2008	Luminaire > Lampadaire
Lampadaire à 3 lumières\nPupitre à musique transformé	Luminaire > Lampadaire
Lampadaire à 4 lumières	Luminaire > Lampadaire
Flambeau	Luminaire > Chandelier > Flambeau
Flambeau 1 lumière	Luminaire > Chandelier > Flambeau
Flambeau 2 lumières	Luminaire > Chandelier > Flambeau
Flambeau 4 lumières	Luminaire > Chandelier > Flambeau
Flambeau 5 lumières	Luminaire > Chandelier > Flambeau
Flambeau monté en lampe	Luminaire > Chandelier > Flambeau
Flambeau portatif	Luminaire > Chandelier > Flambeau
Flambeau portatif à base tournée unie	Luminaire > Chandelier > Flambeau
Flambeau transformable	Luminaire > Chandelier > Flambeau
Flambeau équipé	Luminaire > Chandelier > Flambeau
Flambeau équipé en lampe	Luminaire > Chandelier > Flambeau
Flambeau équipé à base circulaire	Luminaire > Chandelier > Flambeau
Flambeau équipé à base circulaire.	Luminaire > Chandelier > Flambeau
Flambeau équipé à base octogonale	Luminaire > Chandelier > Flambeau
Flambeau équipé à base octogonale	Luminaire > Chandelier > Flambeau
Flambeau équipé à base tournée	Luminaire > Chandelier > Flambeau
Flambeau équipé à base tournée	Luminaire > Chandelier > Flambeau
Flambeau équipé à base tournée doucine.	Luminaire > Chandelier > Flambeau
Flambeau équipé à socle circulaire	Luminaire > Chandelier > Flambeau
Flambeau équipé à socle circulaire.	Luminaire > Chandelier > Flambeau
Flambeaux à double bordures	Luminaire > Chandelier > Flambeau
Flambeaux à simple bordure	Luminaire > Chandelier > Flambeau
Flambeaux à simple bordure RADIATION DES INVENTAIRES \nARRETE DU 09.09.1982\nMOBILIER NATIONAL	Luminaire > Chandelier > Flambeau
Candelabre à 3 lumières	Luminaire > Chandelier > Candélabre
Candelabre à 4 lumières	Luminaire > Chandelier > Candélabre
Candelabre à 6 lumières	Luminaire > Chandelier > Candélabre
Candélabre	Luminaire > Chandelier > Candélabre
Candélabre 4 lumières	Luminaire > Chandelier > Candélabre
Candélabre d'église	Luminaire > Chandelier > Candélabre
Candélabre dit Bout-de-table	Luminaire > Chandelier > Candélabre
Candélabre girandole	Luminaire > Chandelier > Candélabre
Candélabre girandole à 4 lumières	Luminaire > Chandelier > Candélabre
Candélabre transformé en lampe	Luminaire > Chandelier > Candélabre
Candélabre à 6 lumières	Luminaire > Chandelier > Candélabre
Candélabre à 7 lumières	Luminaire > Chandelier > Candélabre
Candélabre à 10 lumières	Luminaire > Chandelier > Candélabre
Candélabre à 11 lumières	Luminaire > Chandelier > Candélabre
Candélabre à 12 lumières	Luminaire > Chandelier > Candélabre
Candélabre à 13 lumières	Luminaire > Chandelier > Candélabre
Candélabre à 14 lumières	Luminaire > Chandelier > Candélabre
Candélabre à 15 lumières	Luminaire > Chandelier > Candélabre
Candélabre à 16 lumières	Luminaire > Chandelier > Candélabre
Candélabre à 17 lumières	Luminaire > Chandelier > Candélabre
Candélabre à 2 lumières	Luminaire > Chandelier > Candélabre
Candélabre à 3 lumières	Luminaire > Chandelier > Candélabre
Candélabre à 3 lumières monté en lampe.	Luminaire > Chandelier > Candélabre
Candélabre à 3 lumières.	Luminaire > Chandelier > Candélabre
Candélabre à 4 lumière\nArrêté ministériel de radiation du 12/06/1954; remis au Min.de la Santé Publ	Luminaire > Chandelier > Candélabre
Candélabre à 4 lumières	Luminaire > Chandelier > Candélabre
Candélabre à 5 lumières	Luminaire > Chandelier > Candélabre
Candélabre à 6 lumières	Luminaire > Chandelier > Candélabre
Candélabre à 7 lumières	Luminaire > Chandelier > Candélabre
Candélabre à 8 lumières	Luminaire > Chandelier > Candélabre
Candélabre à 8 lumières\nRADIATION DES INVENTAIRES \nARRETE DU 18.03.1991 \nCOMITE FRANCE AMERIQUE	Luminaire > Chandelier > Candélabre
Candélabre à 9 lumières	Luminaire > Chandelier > Candélabre
Candélabre à dix lumières	Luminaire > Chandelier > Candélabre
Candélabre à quatre lumières	Luminaire > Chandelier > Candélabre
Candélabre à six lumières	Luminaire > Chandelier > Candélabre
Candélabres à 13 lumières	Luminaire > Chandelier > Candélabre
Applique	Luminaire > Applique
Applique 3 lumières	Luminaire > Applique
Applique 5 lumières	Luminaire > Applique
Applique articulée	Luminaire > Applique
Applique articulée à 3 lumières	Luminaire > Applique
Applique cinq lumières	Luminaire > Applique
Applique de chevet	Luminaire > Applique
Applique de pan de lit	Luminaire > Applique
Applique à 1 lumière	Luminaire > Applique
Applique à 1 lumière orientable	Luminaire > Applique
Applique à 1 lumières	Luminaire > Applique
Applique à 10 lumières	Luminaire > Applique
Applique à 12 lumières	Luminaire > Applique
Applique à 12 lumières\nRadiation, Arrêté du 28.07.1986 AMBASSADE A ANKARA\nConfirmation radiation (	Luminaire > Applique
Applique à 12 lumières\nRadiation, Arrêté du 28.07.1986 AMBASSADE A ANKARA\nConfirmation radiation (	Luminaire > Applique
Applique à 13 lumières	Luminaire > Applique
Applique à 14 lumières	Luminaire > Applique
Applique à 2 lumières	Luminaire > Applique
Applique à 2 lumières\nDécison de radiation 2014/08 du 13/11/2014 pour double prise à l'inventaire(G	Luminaire > Applique
Applique à 2 lumières\nDécison de radiation 2014/08 du 13/11/2014 pour double prise à l'inventaire(G	Luminaire > Applique
Applique à 2 lumières\nRADIATION DES INVENTAIRES \nARRETE DU 30.03.1990 S.H.A.P.E. MARNES LA COQUET	Luminaire > Applique
Applique à 2 lumières\nRadiation des Inventaires \nArrête du 08.10.1990\nMinistère de la Défense	Luminaire > Applique
Applique à 2 plateaux	Luminaire > Applique
Applique à 2 spots	Luminaire > Applique
Applique à 2 spots\nDécision de radiation 2008/3 du 04/06/2008	Luminaire > Applique
Applique à 2 spots\nP.V. REBUT 03 99/0314\nARRETE DU 22.02.1999	Luminaire > Applique
Applique à 2lumières	Luminaire > Applique
Applique à 3 flèches	Luminaire > Applique
Applique à 3 lumières	Luminaire > Applique
Applique à 3 lumières\nRADIATION DES INVENTAIRES ARRETE DU 30.03.1990 S.H.A.P.E. MARNES LA COQUETTE	Luminaire > Applique
Applique à 4 lumières	Luminaire > Applique
Applique à 5 lumières	Luminaire > Applique
Applique à 5 lumières\nRADIATION DES INVENTAIRES \nARRETE DU 30.03.1990 S.H.A.P.E. MARNES LA COQUET	Luminaire > Applique
Applique à 6 lumières	Luminaire > Applique
Applique à 7 lumières	Luminaire > Applique
Applique à 7 lumières\nMajorelle	Luminaire > Applique
Applique à 8 lumières	Luminaire > Applique
Applique à 8 lumières\nBuste de femme nue	Luminaire > Applique
Applique à 9 lumières	Luminaire > Applique
Applique à cinq lumières	Luminaire > Applique
Applique à deux lumières	Luminaire > Applique
Applique à gaz	Luminaire > Applique
Applique à miroir	Luminaire > Applique
Applique à plateau	Luminaire > Applique
Applique à quatre lumières	Luminaire > Applique
Applique à trois flèches	Luminaire > Applique
Applique à une lumière	Luminaire > Applique
Après l'amour	Luminaire > Applique
Statuette	Beaux arts > Sculpture > Statuette
Statuette\nLa parisienne	Beaux arts > Sculpture > Statuette
Statuette\nMort de Bara	Beaux arts > Sculpture > Statuette
Statuette\nPaysan	Beaux arts > Sculpture > Statuette
Statuette Angelot	Beaux arts > Sculpture > Statuette
Statuette Cerf	Beaux arts > Sculpture > Statuette
Statuette Cyrano de Bergerac\nDécision de radiation n° 2006/15\nreversé au Musée du Louvre	Beaux arts > Sculpture > Statuette
Statuette FAUCON HORUS\n	Beaux arts > Sculpture > Statuette
Statuette Femme\nDécision de radiation n° 2007/4\nreversé au Musée du Louvre	Beaux arts > Sculpture > Statuette
Statuette Henri IV à cheval	Beaux arts > Sculpture > Statuette
Statuette Hébé	Beaux arts > Sculpture > Statuette
Statuette La vérité	Beaux arts > Sculpture > Statuette
Statuette Le char d'Amphitrite	Beaux arts > Sculpture > Statuette
Statuette Racine	Beaux arts > Sculpture > Statuette
Statuette Vénus\nDécision de radiation n° 2007/4\nreversé au Musée du Louvre	Beaux arts > Sculpture > Statuette
Statuette d' Eléphant	Beaux arts > Sculpture > Statuette
Statuette d'Empereur romain	Beaux arts > Sculpture > Statuette
Statuette de Napoléon Ier	Beaux arts > Sculpture > Statuette
Statuette de bacchante	Beaux arts > Sculpture > Statuette
Statuette de cheval	Beaux arts > Sculpture > Statuette
Statuette de femme	Beaux arts > Sculpture > Statuette
Statuette du Duc de Berry	Beaux arts > Sculpture > Statuette
Statuette enfant au poisson\nDécision de radiation n° 2006/15\nreversé au Musée du Louvre	Beaux arts > Sculpture > Statuette
Statuette équestre	Beaux arts > Sculpture > Statuette
BUSTE Anne Louis GIRODET TRIOSON	Beaux arts > Sculpture > Statue
BUSTE D EUSTACHE LESUEUR	Beaux arts > Sculpture > Statue
BUSTE DE CHARLES PERCIER	Beaux arts > Sculpture > Statue
BUSTE DE DAVID	Beaux arts > Sculpture > Statue
BUSTE DE FEMME	Beaux arts > Sculpture > Statue
BUSTE DE FRANCOIS MANSART	Beaux arts > Sculpture > Statue
BUSTE DE JEAN JOUVENET	Beaux arts > Sculpture > Statue
BUSTE DE JOSEPH PARROCEL	Beaux arts > Sculpture > Statue
BUSTE DE Louise Elisabeth VIGEE LE BRUN	Beaux arts > Sculpture > Statue
BUSTE DE PAUL DELAROCHE	Beaux arts > Sculpture > Statue
BUSTE DE PIERRE GUERIN	Beaux arts > Sculpture > Statue
BUSTE DE PROFIL DU BARON GERARD	Beaux arts > Sculpture > Statue
BUSTE DE SIMON VOUET	Beaux arts > Sculpture > Statue
BUSTE DE STEUBEN	Beaux arts > Sculpture > Statue
BUSTE DE VAUCANSON	Beaux arts > Sculpture > Statue
BUSTE SEBASTIEN LECLERC	Beaux arts > Sculpture > Statue
Buste	Beaux arts > Sculpture > Statue
Buste\n	Beaux arts > Sculpture > Statue
Buste\nDécision de radiation n° 2007/4\nreversé au Musée du Louvre	Beaux arts > Sculpture > Statue
Buste\nDécision de radiation n°2014/03 du 10.04.2014 pour être reversé aux collections du FNAC	Beaux arts > Sculpture > Statue
Buste\nP.V. VENTE 47 97/2075\nARRETE DU 09.02.98\n	Beaux arts > Sculpture > Statue
Buste du Duc d'Angoulême	Beaux arts > Sculpture > Statue
Buste La rêverie\n	Beaux arts > Sculpture > Statue
Buste PRIMAVERA\n	Beaux arts > Sculpture > Statue
Buste d' "Impératrice"	Beaux arts > Sculpture > Statue
Buste d' Apollon	Beaux arts > Sculpture > Statue
Buste d' Auguste	Beaux arts > Sculpture > Statue
Buste d' Emile Loubet	Beaux arts > Sculpture > Statue
Buste d' Empereur Romain	Beaux arts > Sculpture > Statue
Buste d' Enfant	Beaux arts > Sculpture > Statue
Buste d' HENRI II\n	Beaux arts > Sculpture > Statue
Buste d' Homme	Beaux arts > Sculpture > Statue
Buste d' Homme\nDécision de radiation n° 2006/15\nreversé au Musée du Louvre	Beaux arts > Sculpture > Statue
Buste d' Officier	Beaux arts > Sculpture > Statue
Buste d' homme	Beaux arts > Sculpture > Statue
Buste d'Ariane	Beaux arts > Sculpture > Statue
Buste d'Empereur romain	Beaux arts > Sculpture > Statue
Buste d'Henri IV	Beaux arts > Sculpture > Statue
Buste d'Ophélie\nDécision de radiation n° 2006/15\nreversé au Musée du Louvre	Beaux arts > Sculpture > Statue
Buste d'enfant	Beaux arts > Sculpture > Statue
Buste de Bacchante\nDécision de radiation n° 2006/15\nreversé au Musée du Louvre	Beaux arts > Sculpture > Statue
Buste de Brustus	Beaux arts > Sculpture > Statue
Buste de Carnot	Beaux arts > Sculpture > Statue
Buste de Charles Meynier	Beaux arts > Sculpture > Statue
Buste de Charles X	Beaux arts > Sculpture > Statue
Buste de Claude Debussy	Beaux arts > Sculpture > Statue
Buste de Claude Monet	Beaux arts > Sculpture > Statue
Buste de Colbert	Beaux arts > Sculpture > Statue
Buste de Commode	Beaux arts > Sculpture > Statue
Buste de Cybèle	Beaux arts > Sculpture > Statue
Buste de Dame Bérangère	Beaux arts > Sculpture > Statue
Buste de Danton	Beaux arts > Sculpture > Statue
Buste de Danton\n	Beaux arts > Sculpture > Statue
Buste de Desaix	Beaux arts > Sculpture > Statue
Buste de Descartes	Beaux arts > Sculpture > Statue
Buste de Diane	Beaux arts > Sculpture > Statue
Buste de Diane\nDécision de radiation n° 2007/4\nreversé au Musée du Louvre	Beaux arts > Sculpture > Statue
Buste de Diane\nDécision de radiation n° 2006/15\nreversé au Musée du Louvre	Beaux arts > Sculpture > Statue
Buste de F. PONSARD	Beaux arts > Sculpture > Statue
Buste de FEMME	Beaux arts > Sculpture > Statue
Buste de FLORE	Beaux arts > Sculpture > Statue
Buste de Fallières	Beaux arts > Sculpture > Statue
Buste de Faune	Beaux arts > Sculpture > Statue
Buste de Faustine	Beaux arts > Sculpture > Statue
Buste de Femme	Beaux arts > Sculpture > Statue
Buste de Femme\nDécision de radiation n° 2007/4\nreversé au Musée du Louvre	Beaux arts > Sculpture > Statue
Buste de Femme\nDécision de radiation n° 2006/15\nreversé au Musée du Louvre	Beaux arts > Sculpture > Statue
Buste de Femme\nDécision de radiation n°2015/02 du 27/03/2015 pour restitution au Musée des arts Déc	Beaux arts > Sculpture > Statue
Buste de Femme\nP.V. VENTE 47 97/2075\nARRETE DU 09.02.98\n	Beaux arts > Sculpture > Statue
Buste de Femme\nP.V. VENTE 47 97/2075\nARRETE DU 09.02.98\nTETE DE FEMME	Beaux arts > Sculpture > Statue
Buste de Fillette\nPris par erreur aux inventaires du Mobilier National appartient au FNAC (FNAC n°	Beaux arts > Sculpture > Statue
Buste de Franklin	Beaux arts > Sculpture > Statue
Buste de François 1er	Beaux arts > Sculpture > Statue
Buste de Félix Faure	Beaux arts > Sculpture > Statue
Buste de Gabriel\nP.V. VENTE 47 97/2075\nARRETE DU 09.02.98\n	Beaux arts > Sculpture > Statue
Buste de Jean Jacques Rousseau	Beaux arts > Sculpture > Statue
Buste de Jean de Rotrou	Beaux arts > Sculpture > Statue
Buste de Jeune Garçon\nDécision de radiation n° 2006/15\nreversé au Musée du Louvre	Beaux arts > Sculpture > Statue
Buste de Jules CHERET	Beaux arts > Sculpture > Statue
Buste de Jules Ferry	Beaux arts > Sculpture > Statue
Buste de Jules Grévy	Beaux arts > Sculpture > Statue
Buste de Jérôme Bonaparte	Beaux arts > Sculpture > Statue
Buste de L'été	Beaux arts > Sculpture > Statue
Buste de LA REPUBLIQUE	Beaux arts > Sculpture > Statue
Buste de LOUIS XVIII	Beaux arts > Sculpture > Statue
Buste de La loi	Beaux arts > Sculpture > Statue
Buste de Louis Napoléon	Beaux arts > Sculpture > Statue
Buste de Louis XIV	Beaux arts > Sculpture > Statue
Buste de Louis XV	Beaux arts > Sculpture > Statue
Buste de Louis XVIII	Beaux arts > Sculpture > Statue
Buste de Louis-Philippe	Beaux arts > Sculpture > Statue
Buste de Lucilla	Beaux arts > Sculpture > Statue
Buste de Madame de Pompadour	Beaux arts > Sculpture > Statue
Buste de Mademoiselle ( Louise Marie-Thérèse d'Artois)	Beaux arts > Sculpture > Statue
Buste de Mademoiselle Louise Marie-Thérèse d'Artois	Beaux arts > Sculpture > Statue
Buste de Marianne	Beaux arts > Sculpture > Statue
Buste de Maréchal\nDécision de radiation N° 2004/10\nRestitution au Ministère des Affaires Etrangère	Beaux arts > Sculpture > Statue
Buste de Minerve	Beaux arts > Sculpture > Statue
Buste de Mirabeau	Beaux arts > Sculpture > Statue
Buste de Molière	Beaux arts > Sculpture > Statue
Buste de Méléagre\nDécision de radiation n° 2006/15\nreversé au Musée du Louvre	Beaux arts > Sculpture > Statue
Buste de NAPOLEON IER EN HERMES	Beaux arts > Sculpture > Statue
Buste de Napoléon	Beaux arts > Sculpture > Statue
Buste de Napoléon III	Beaux arts > Sculpture > Statue
Buste de Napoléon Ier	Beaux arts > Sculpture > Statue
Buste de Noël Hallé\nDécision de radiation N° 2004/10\nRestitution au Ministère des Affaires Etrangè	Beaux arts > Sculpture > Statue
Buste de Percier	Beaux arts > Sculpture > Statue
Buste de Poincaré	Beaux arts > Sculpture > Statue
Buste de Raymond Poincaré	Beaux arts > Sculpture > Statue
Buste de Robespierre	Beaux arts > Sculpture > Statue
Buste de Romain	Beaux arts > Sculpture > Statue
Buste de Rotrou\nDécision de radiation n° 2006/15\nreversé au Musée du Louvre	Beaux arts > Sculpture > Statue
Buste de Saint Charles Borromée	Beaux arts > Sculpture > Statue
Buste de Saint Vincent de Paul	Beaux arts > Sculpture > Statue
Buste de Thiers	Beaux arts > Sculpture > Statue
Buste de Van der Meulen	Beaux arts > Sculpture > Statue
Buste de Voltaire	Beaux arts > Sculpture > Statue
Buste de femme	Beaux arts > Sculpture > Statue
Buste de femme\nDécision de radiation n° 2007/4\nreversé au Musée du Louvre	Beaux arts > Sculpture > Statue
Buste de femme\nRADIATION DES INVENTAIRES \nARRETE DU 02.11.1992\nCHATEAU DE RAMBOUILLET	Beaux arts > Sculpture > Statue
Buste de jeune garçon	Beaux arts > Sculpture > Statue
Buste de l' Empereur Adrien\nDécision de radiation n° 2007/4\nreversé au Musée du Louvre	Beaux arts > Sculpture > Statue
Buste de l' Impératrice Eugénie	Beaux arts > Sculpture > Statue
Buste de l' Impératrice Joséphine	Beaux arts > Sculpture > Statue
Buste de l'Empereur Marc-Aurèle\nDécision de radiation n° 2007/4\nreversé au Musée du Louvre	Beaux arts > Sculpture > Statue
Buste de l'Impératrice Eugénie	Beaux arts > Sculpture > Statue
Buste de la Duchesse d'Angoulême	Beaux arts > Sculpture > Statue
Buste de la Duchesse de Berry	Beaux arts > Sculpture > Statue
Buste de la Princesse Mathilde	Beaux arts > Sculpture > Statue
Buste de la République	Beaux arts > Sculpture > Statue
Buste de la république	Beaux arts > Sculpture > Statue
Buste de son Altesse Mademoiselle	Beaux arts > Sculpture > Statue
Buste di Président Doumergue	Beaux arts > Sculpture > Statue
Buste du Duc d'Angoulême	Beaux arts > Sculpture > Statue
Buste du Duc d'Angoulême en costume de colonel (dit Duc de Bordeaux)	Beaux arts > Sculpture > Statue
Buste du Duc d'Angoulême"	Beaux arts > Sculpture > Statue
Buste du Duc de Berry	Beaux arts > Sculpture > Statue
Buste du Duc de Bordeaux	Beaux arts > Sculpture > Statue
Buste du Duc de Bordeaux (enfant)	Beaux arts > Sculpture > Statue
Buste du Duc de Bordeaux enfant	Beaux arts > Sculpture > Statue
Buste du Général Lafayette	Beaux arts > Sculpture > Statue
Buste du Général de Gaulle	Beaux arts > Sculpture > Statue
Buste du MARECHAL DE VILLARS	Beaux arts > Sculpture > Statue
Buste du Printemps	Beaux arts > Sculpture > Statue
Buste du Printemps n° 2	Beaux arts > Sculpture > Statue
Buste du Président Doumergue	Beaux arts > Sculpture > Statue
Buste du Président Fallières	Beaux arts > Sculpture > Statue
Buste du Président François Mitterrand	Beaux arts > Sculpture > Statue
Buste du Président Poincaré	Beaux arts > Sculpture > Statue
Buste duPrésident Doumergue	Beaux arts > Sculpture > Statue
Statue	Beaux arts > Sculpture > Statue
Statue Femme nue assise en tailleur	Beaux arts > Sculpture > Statue
Statue d'un cavalier	Beaux arts > Sculpture > Statue
Statue de Diane	Beaux arts > Sculpture > Statue
Statue de Déesse Lionne	Beaux arts > Sculpture > Statue
Statue de Laurent de Médicis	Beaux arts > Sculpture > Statue
Statue de Minerve	Beaux arts > Sculpture > Statue
Statue de Saint François Régis	Beaux arts > Sculpture > Statue
Statue de Saint-Jean	Beaux arts > Sculpture > Statue
Statue de Saint-Roch	Beaux arts > Sculpture > Statue
Statue de saint-évêque	Beaux arts > Sculpture > Statue
Statue du Laocon	Beaux arts > Sculpture > Statue
Statue équestre	Beaux arts > Sculpture > Statue
Statue équestre de Louis XIV	Beaux arts > Sculpture > Statue
Statuede Vénus et Amour\n	Beaux arts > Sculpture > Statue
Statues, vases, vasques et bassins du château et du parc de Versailles	Beaux arts > Sculpture > Statue
Gravure en couleur	Beaux arts > Art graphique > Gravure
Gravure encadrée. "Le roi à la chasse du Cerf avec les dames"	Beaux arts > Art graphique > Gravure
Gravure encadrée. LE SOIR	Beaux arts > Art graphique > Gravure
Gravure encadrée.. LE PONT NEUF	Beaux arts > Art graphique > Gravure
Gravure encadrée.LE MATIN	Beaux arts > Art graphique > Gravure
Meuble pour le troisième salon de l'impératrice au Palais de Compiègne	Textile > Tissu précieux
Table d'appoint	Meuble > Table > Table d'appoint
Table d'appoint modèle de 1930	Meuble > Table > Table d'appoint
Table d'appoint\nModèle Tandem	Meuble > Table > Table d'appoint
Table d'appoint\nModèle Rondo	Meuble > Table > Table d'appoint
